+ + + + + + + +
+ + + + - - - +
+ X - - - + - +
+ * - - X + - +
+ - @ - - $ - +
+ - @ - - - - +
+ - X @ $ @ - +
+ - - - - - - +
+ X - - - - - +
+ + + + + + + +
