+ + + + + + + +
+ - - - $ $ - +
+ - - X - - - +
+ - - @ X @ - +
+ - - - - - * +
+ + X - - @ - +
+ + - - - - - +
+ + + + + + + +
